@@@@@@@@@@@@@@@@@@@@@@@@@@@@@@@@
@..............................@
@..............................@
@..............................@
@..............................@
@..............................@
@..............................@
@..............................@
@..............................@
@..............................@
@..............................@
@..............................@
@.........@....................@
@.........@....................@
@.........@.@..................@
@.........@.@@@................@
@.........@....................@
@.........@@@@@................@
@..............................@
@..............................@
@..............................@
@..............................@
@..........@...................@
@..........@...................@
@..........@...................@
@..............................@
@..............................@
@..........@@@@................@
@..............................@
@..............................@
@..............................@
@@@@@@@@@@@@@@@@@@@@@@@@@@@@@@@@

